.................
.................
.................
.......::........
......::::.......
.....::::::......
....::::::::.....
...:b::::::::....
...::::::::a:....
...::c:::::::....
....::::::::.....
.....::#l::......
.......##........
.......##........
..1.GG.##.GG.X...
<<<<<<<<<<<<<<<<<